Fastest-Growing Stocks Expectin	"['NUE', 'STLD', 'MTDR', 'FANG', 'ZIM', 'ESTE', 'CPE', 'AMN', 'CE', 'TX', 'PFE', 'SIMO', 'MU']"
Analysts' Favorite S&P 500 Valu	"['TMUS', 'DISH', 'VIAC', 'DISCA', 'NWSA', 'GM', 'LEN', 'GPS', 'MHK', 'ALK', 'NLSN', 'DXC']"
"Analysts¡¯ Price Targets, S&P 50"	"['PENN', 'CZR', 'BBWI', 'ETSY', 'TPR', 'KMX', 'CMG', 'ROST', 'GM', 'DHI', 'LEN', 'AMZN', 'NKE', 'APTV', 'PVH', 'TJX', 'TGT', 'PHM', 'ULTA', 'DRI']"
Dividend Growth Stocks - Divide	"['GPS', 'DRI', 'BBY', 'WHR', 'RL', 'YUM', 'TPR', 'HD', 'GPC', 'SBUX']"
Consumer Discretionary Sector -	"['NCLH', 'RCL', 'CCL', 'LVS', 'TSLA', 'BKNG', 'WYNN', 'HLT', 'EXPE', 'MAR', 'MGM', 'ETSY', 'AMZN', 'UAA', 'APTV', 'CMG', 'LEN', 'GM', 'DHI', 'BWA']"
MORGAN STANLEY¡¯S FAVORITE STOCK	"['FFIV', 'TWNK', 'HLI', 'GWW', 'RJF']"
NASDAQ 100 REBOUND CANDIDATES -	"['ALGN', 'AMZN', 'FB', 'FISV', 'GOOGL', 'LULU', 'MNST', 'MTCH', 'NFLX', 'PYPL', 'QCOM', 'ROST', 'WDAY']"
Inflation-sensitive Stocks - In	"['AAPL', 'CAN', 'ADBE', 'ADI', 'ADP', 'ADSK', 'AKAM', 'AMAT', 'AMD', 'ANET', 'ANSS', 'APH', 'AVGO', 'BR', 'CDAY', 'CDNS', 'CDW', 'CRM', 'CSCO', 'CTSH', 'CTXS', 'DXC', 'ENPH', 'EPAM', 'RRIV', 'FIS', 'FISV', 'FLT', 'FTNT', 'GLW', 'GPN', 'HPE', 'HPQ', 'IBM', 'INTC', 'INTU', 'IPGP', 'IT', 'JKHY', 'JNPR', 'KEYS', 'KLAC', 'LRCX', 'MA', 'MCHP', 'MPWR', 'MSFT', 'MSI', 'MU', 'NLOK', 'NOW', 'NTAP', 'NVDA', 'NXPI', 'ORCL', 'PAYC', 'PAYX', 'PTC', 'PYPL', 'QCOM', 'QRVO', 'SEDG', 'SNPS', 'STX', 'SWKS', 'TDY', 'TER', 'TRMB', 'TXN', 'TYL', 'V', 'VRSN', 'WDC', 'XLNX', 'ZBRA']"
WOLFE¡¯S STOCK PICKS FOR A STEEP	"['EXPE', 'BBY', 'WBA', 'C', 'MET', 'LMT', 'SWK', 'WDC', 'DOW', 'VTR']"
THESE STOCKS CAN DO WELL WHEN I	"['ZION', 'FE', 'DIS', 'SCHW', 'HPE', 'MU', 'VMC', 'FCX', 'FANG', 'DVN']"
Top Value S&P 500 Stocks - Top 	"['F', 'MRO', 'XOM', 'MPC', 'VLO', 'WFC', 'PBCT', 'CFG', 'KEY', 'FITB', 'PNC', 'HPE', 'MOS']"
GOLDMAN¡¯S EARNINGS UPSIDE_DOWNS	"['BA', 'BAC', 'LOW', 'DNUT', 'ABNDX', 'TAP']"
EVERCORE ISI¡¯S ¡°AT THE MARGINS¡±	"['CMG', 'DHI', 'LOW', 'MCD', 'NKE', 'SYY', 'CAT', 'NSC', 'UNP', 'UPS']"
25 Cheapest Stocks - 25 Cheapes	"['PRU', 'PBR', 'KT', 'RLGY', 'HPE', 'GPI', 'BGFV', 'BZH', 'AAN', 'CVLG', 'CONN', 'ZEUS', 'UNM', 'MT', 'GNW', 'ODP', 'FL', 'BIG', 'OPY', 'TX', 'GGB', 'FTI', 'PKX', 'QIWI', 'GGAL']"
JPMORGAN_ JANUARY FOCUS LIST - 	"['BK', 'PLUG', 'UTHR', 'CAT', 'ALK', 'TGT', 'FB', 'LLY', 'LVS', 'AAPL']"
Stocks reporting next week usua	"['SBNY', 'PG', 'UNH', 'BKU', 'UNP', 'WNS', 'ISRG', 'NLFX', 'SIVB']"
Worst S&P 500 performers from 5	"['PENN', 'VIAC', 'DISCA', 'MRNA', 'GPS', 'BIIB', 'TWTR', 'ENPH', 'ETSY', 'LVS', 'WYNN', 'PYPL', 'GNRC', 'ATVI', 'MKTX', 'IPGP', 'PAYC', 'NCLH', 'CTXS', 'SEDG', 'GPN', 'MTCH', 'CDAY', 'ZBH', 'LUV']"
Semiconductor stock screen - Se	"['WOLF', 'SPWR', 'SLAB', 'LSCC', 'SYNA', 'XLNX', 'ADI', 'AVGO', 'AMAT', 'SGH', 'LRCX', 'SWKS', 'CRUS', 'ASX', 'FSLR', 'STM', 'MRVL', 'DIOD', 'MU', 'TSM', 'OLED', 'NVDA', 'QRVO', 'ALGM', 'QCOM', 'ASML', 'UMC', 'SMTC', 'TER', 'MPWR', 'AMD', 'NXPI', 'MCHP', 'RMBS', 'MKSI', 'CDNS', 'ON', 'TXN', 'KLAC', 'SNPS', 'POWI', 'MXL', 'ENTG', 'INTC']"
Sector Themes in 2022 - Sector 	"['XLE', 'XLC', 'XLF', 'XLU', 'XLI', 'XLK', 'XLV', 'XLY', 'XLB', 'XLP', 'XLRE', 'XHB', 'XRT', 'SMH', 'GDX', 'XME']"
GOLDMAN SACHS¡¯ CHEAP AND HIGH-V	"['ATVI', 'BMY', 'DRI', 'DKS', 'INTU', 'LVS', 'FB', 'SU', 'VRTX', 'YELP']"
RATE HIKE DOW WINNERS _ LOSERS 	"['GS', 'JPM', 'BA', 'UNH', 'CAT', 'CRM', 'PG', 'V', 'NKE', 'AMGN']"
14 bank stocks expected to achi	"['CADE', 'HBAN', 'SBNY', 'EBC', 'STT', 'BK', 'WAL', 'NTRS', 'NYCB', 'FRC', 'WBS', 'VLY', 'FBP', 'TFC']"
Cheap Russell 1000 stocks based	"['COP', 'EOG', 'PXD', 'PSX', 'LNG', 'FANG', 'MRO', 'EQT', 'HFC', 'C', 'RF', 'CFG', 'BPOP', 'PACW', 'DFS', 'SYF', 'ALLY', 'OMF', 'SLM', 'EQH', 'VOYA', 'MET', 'AIG', 'GOCO', 'NLY', 'AGNC', 'NRZ', 'NYCB', 'GTES', 'CE', 'MOS', 'MOS', 'GILD', 'CI', 'JASS', 'PCG', 'VST', 'VIAC', 'FOXA', 'DISCA', 'ATUS', 'GM', 'PHM', 'BC', 'DXC', 'ADS']"
BANK OF AMERICA¡¯S FAVORITE SEMI	"['NVDA', 'MRVL', 'AMD', 'AVGO', 'KLAC', 'TER', 'AMAT', 'MU', 'ON', 'GFS']"
Russell 1000 companies with hig	"['AZPN', 'DLB', 'CDNS', 'ADBE', 'CSGP', 'TPR', 'PM', 'PM', 'ROP', 'CL', 'PVH']"
Consistent winners when tech is	"['DG', 'HSY', 'PG', 'AJG', 'NI', 'ED']"
39 stocks in the S&P 500 that h	"['ABMD', 'ACN', 'ALGN', 'BBWI', 'BIO', 'CDAY', 'CDNS', 'CPRT', 'CRL', 'CRM', 'CTAS', 'DHI', 'DHR', 'DXCM', 'ENPH', 'EPAM', 'ETSY', 'FTNT', 'GNRC', 'HUM', 'IDXX', 'INTU', 'IRM', 'IT', 'LEN', 'MRNA', 'NFLX', 'NOW', 'PAYC', 'POOL', 'SBAC', 'SEDG', 'SNPS', 'TECH', 'TYL', 'WST', 'ZBRA', 'ZTS']"
CREDIT SUISSE¡¯S TOP PICKS FOR J	"['PZZA', 'MRVL', 'UPS', 'PVH', 'MSFT', 'AMZN', 'DIS', 'EMR', 'BMRN', 'DFS']"
Cash Cow Value Stocks - Cash Co	"['ABBV', 'BMY', 'COP', 'CVS', 'GILD', 'IBM', 'INTC', 'MO', 'PFE', 'XOM', 'ABBV', 'AM', 'DOW', 'HRB', 'IBM', 'LUMN', 'LYB', 'MO', 'XOM', 'XRX', 'BYD', 'COP', 'FANG', 'LAD', 'LH', 'LKQ', 'LOPE', 'LYLT', 'NXST', 'OLN', 'TRGP', 'VSCO']"
These big tech stocks have drop	"['TWTR', 'ENPH', 'PYPL', 'ETSY', 'ATVI', 'SEDG', 'IPGP', 'PAYC', 'GPN', 'CTXS', 'CDAY', 'CRM', 'ADBE', 'FIS', 'DXC', 'ADSK', 'PTC', 'SWKS', 'QRVO', 'INTC', 'MPWR', 'EBAY', 'NVDA', 'TTWO', 'FLT']"
DIVIDEND ETF TOP 10 STOCKS YTD 	"['XOM', 'PBCT', 'NUE', 'CAT', 'T', 'OZK', 'TDS', 'CFR', 'MDT', 'EMR']"
RETURN DURING 7 BIGGEST MONTHLY	"['COP', 'MOS', 'BA', 'OKE', 'XOM', 'NWSA', 'ORLY', 'CVX', 'AIG']"
20 cheap value stocks - 20 chea	"['EQH', 'OMF', 'OLN', 'ALLY', 'NXST', 'LAD', 'SYF', 'JAZZ', 'VSCO', 'EQT', 'HLF', 'VNT', 'WAL', 'GTES', 'DAR', 'BYD', 'EWBC', 'NCR', 'TNL', 'AIZ']"
RBC CAPITAL MARKETS_ TOP IDEAS 	"['AMZN', 'COP', 'MA', 'MTB', 'TWLO']"
23 dividend stocks that can pas	"['NEM', 'WEC', 'BMY', 'ABBV', 'NRG', 'EVRG', 'EIX', 'ETR', 'AEP', 'SRE', 'PM', 'CVX', 'AMCR', 'GILD', 'PEG', 'KMI', 'SO', 'WMB', 'PNW', 'K', 'XOM', 'MMM', 'FRT']"
BANK OF AMERICA¡¯S TOP U.S. STOC	"['C', 'CARR', 'CNHI', 'CRWD', 'LW', 'OXY', 'REXR', 'VIAC', 'XEL']"
Goldman says to pick stocks in 	"['ABC', 'MCK', 'AAPL', 'KO', 'FANG', 'RE', 'UAA', 'SWKS', 'WDC', 'ROST', 'MP', 'MA', 'UTHR', 'AZPN', 'NVDA', 'OLED', 'MRVL', 'LSCC', 'ADSK', 'MPWR']"
The ¡®best¡¯ dividend compounders	"['ABBV', 'TROW', 'ITW', 'AFL', 'ADP', 'ABT', 'NEE', 'APD', 'MKC', 'ATO', 'TGT', 'MCD']"
RBC¡¯S LONG-TERM PICKS FOR PATIE	"['CRWD', 'SHOP', 'PYPL', 'EL', 'PG', 'TSLA', 'COUR', 'SIVB', 'LPX', 'BKR']"
Goldman¡¯s favorite dividend and	"['QCOM', 'ADP', 'BR', 'VLO', 'PEP', 'MS', 'RF', 'RL', 'TPR', 'F', 'AAPL', 'BBWI', 'BIIB', 'SJM', 'HPQ', 'MPC', 'DGX', 'COF', 'TWTR', 'PSA']"
Wall Street analysts¡¯ favorite 	"['CRM', 'BA', 'V', 'DIS', 'MRK', 'WMT', 'GS', 'AXP', 'DOW', 'HON', 'CAT', 'VZ', 'JPM', 'NKE', 'CVX', 'MSFT', 'MMM', 'KO', 'JNJ', 'IBM', 'INTC', 'AMGN', 'TRV', 'MCD', 'HD', 'WBA', 'UNH', 'AAPL', 'CSCO', 'PG', 'ALK', 'CZR', 'GNRC', 'PYPL', 'NWSA', 'TMUS', 'GPN', 'LUV', 'SLB', 'CRM', 'BBWI', 'MDT', 'PSX', 'EA', 'PXD', 'GM', 'TFX', 'CMCSA', 'EOG', 'SYF', 'RUN', 'APPS', 'JAZZ', 'LAD', 'CRNC', 'ZD', 'ELY', 'VSCO', 'RAMP', 'MLKN', 'PRG', 'CHX', 'DAR', 'AXON', 'EQT', 'IAA', 'AZTA', 'HQY', 'SAIL', 'VNT', 'QURE', 'TCMD', 'ZYXI', 'CARA', 'TREE', 'JYNT', 'TALO', 'REGI', 'LPSN', 'BLFS', 'OPRX', 'CUTR', 'SEM', 'HIBB', 'PLMR', 'CHRS', 'CELH', 'JRVR', 'NEO', 'VCEL']"
GOLDMAN SACHS_ TOP STOCKS FOR 2	"['AMZN', 'WMT', 'BA', 'NKE', 'CMG']"
BANK OF AMERICA¡¯S TOP PICKS FOR	"['DIS', 'MDLZ', 'CVS', 'WFC', 'FFIV']"
Stocks in bear markets that ana	"['PDD', 'BIDU', 'JD', 'MELI', 'CZR', 'GNRC', 'ALK', 'PYPL', 'CRWD', 'TCOM', 'TMUS', 'ENPH', 'GPN', 'NTES', 'LUV', 'ATVI', 'FIS', 'MTCH', 'LDOS', 'MDT', 'TFX', 'WRK', 'PTC', 'ZBH', 'PSX', 'BA', 'OKTA', 'DIS', 'GLW', 'LW']"
CHEAPEST STOCKS FOR 2022 - CHEA	"['DHI', 'NWSA', 'SLB', 'FANG', 'EOG', 'PXD', 'PSX', 'DVN', 'VLO', 'BKR', 'WMB', 'MPC', 'ALK', 'FCX', 'ATVI', 'EA', 'PTC']"
Wall Street's favorite Nasdaq s	"['MELI', 'CRWD', 'TMUS', 'INTU', 'OKTA', 'WDAY', 'AMZN', 'MRVL', 'GOOGL', 'MSFT', 'SNPS']"
Wall Street's favorite Dow stoc	"['CRM', 'V', 'DIS', 'GS', 'WMT', 'NKE', 'CVX', 'MSFT']"
Barron's Stock Picks for 2022 -	"['Amazon.com / AMZN', 'AT&T / T', 'Berkshire Hathaway / BRK.A', 'General Motors / GM', 'Hertz Global Holdings / HTZ', 'IBM / IBM', 'Johnson & Johnson / JNJ', 'Nordstrom / JWN', 'Royal Dutch Shell / RDS.B', 'Visa / V']"
BofA's Top Stock Picks For 2022	"['DIS', 'BWA', 'XOM', 'EMN', 'CVS', 'WFC', 'WELL', 'ETN', 'NRG', 'MDLZ', 'FFIV', 'SPY']"
WELLS FARGO¡¯S DOWNSIDE PROTECTI	"['RH', 'FB', 'MSFT', 'VRTX', 'AAPL', 'JPM', 'WMT', 'COP', 'CMS', 'UAA']"
STOCKS WITH EARNINGS STABILITY 	"['FB', 'MCD', 'LOW', 'KO', 'PEP', 'MDLZ', 'MNST', 'SCHW', 'CVS', 'CI', 'HUM', 'MA', 'PYPL']"
JEFFERIES TOP STOCK PICKS FOR 2	"['VRTX', 'TXT', 'NWL', 'ELY', 'BLMN', 'AMZN', 'FCX', 'SIX', 'CVNA', 'CVS']"
JPMORGAN¡¯S TOP INTERNET STOCK P	"['AMZN', 'FB', 'NFLX', 'UBER', 'SPOT', 'TWTR']"
UBS¡¯ HIGH CONVICTION STOCK PICK	"['ONON', 'ALK', 'CHK', 'TMUS', 'SQ', 'SBNY', 'ULTA', 'GE', 'ADI', 'MSFT']"
Stocks that work well when the 	"['FCX', 'NVDA', 'FMC', 'AES', 'J', 'PH', 'GPN', 'PWR', 'DVN']"
STOCKS WITH FAST REVENUE GROWTH	"['GOOGL', 'MA', 'BKNG', 'MTCH', 'ADSK', 'MRVL', 'PYPL', 'FB', 'UTHR', 'ETSY']"
S&P 500 Sectors' Cheapest Stock	"['T', 'DISCA', 'LUMN', 'PHM', 'DHI', 'LEN', 'MO', 'WBA', 'TAP', 'APA', 'CTRA', 'FANG', 'LNC', 'IVZ', 'COF', 'VTRS', 'OGN', 'BMY', 'ALK', 'DAL', 'CMI', 'MOS', 'LYB', 'CF', 'CBRE', 'VNO', 'SPG', 'WDC', 'HPE', 'WU', 'NRG', 'EIX', 'SRE']"
JEFFERIES_ INFLATION STOCK PICK	"['ORLY', 'STLA', 'MCHP', 'YETI', 'BA', 'FCX', 'AMD', 'DE', 'TJX', 'WMT']"
Dividend-stock screen results -	"['DVN', 'MPC', 'VLO', 'EOG', 'PSX', 'DTM', 'KTB', 'WMB', 'CVX', 'MRK', 'BMY', 'KO', 'NRG', 'CC', 'HBI', 'NEM', 'LYB', 'MET', 'CFG', 'FHN', 'FNB', 'JRVR', 'EFC', 'VLY', 'C', 'NYCB', 'PPBI', 'CTRE', 'OFC', 'MPW', 'ADC', 'EPRT', 'DEA', 'IRM', 'KRG', 'AHH', 'FCPT', 'ACC', 'CUZ', 'SBRA', 'CHCT', 'UE', 'PEAK', 'NNN', 'O', 'CCI', 'HIW', 'RPT', 'HPP', 'SPG']"
"S&P500, Market Cap $10bn, GPM 5"	"['MSFT', 'GOOGL', 'FB', 'NVDA', 'V', 'ADBE', 'TMO', 'AVGO', 'KO', 'QCOM', 'MCD', 'MS', 'TXN', 'UNP', 'SCHW', 'BLK', 'PM', 'GS', 'ISRG', 'AMT', 'AMGN', 'PLD', 'SPGI', 'ZTS', 'ADI', 'GILD', 'CCI', 'CSX', 'ICE', 'EW', 'MCO', 'REGN', 'NSC', 'KLAC', 'MSCI', 'VRTX', 'IDXX', 'CDNS', 'SPG', 'ROP', 'MNST', 'ATVI', 'ANET', 'MTCH', 'VRSK', 'ANSS', 'EXR', 'VRSN', 'GRMN', 'TER', 'DRE', 'PKI', 'HOLX', 'KIM', 'NLOK', 'REG']"
JP Morgan¡¯s Top Picks for 2022 	"['ABBV', 'ALL', 'BAC', 'CAT', 'LNG', 'DOW', 'FISV', 'GM', 'LEN', 'QCOM', 'AMZN', 'AAPL', 'ANET', 'DHR', 'DIS', 'LLY', 'HON', 'PYPL', 'TMO']"
MORGAN STANLEY¡¯S LARGE CAP DEFE	"['KO', 'STZ', 'KHC', 'WBA', 'WMT', 'BMY', 'MRK', 'PFE', 'RTX', 'VMW', 'AEP', 'DUK']"
Investors eagerly buy the dip ?	"['MRNA', 'CRM', 'NCLH', 'FTNT', 'AAL', 'RCL', 'CZR', 'UAL', 'NOW', 'DAL', 'CCL', 'PENN', 'WYNN', 'AMD', 'ETSY', 'CF', 'ENPH', 'BA', 'BBWI', 'ALK', 'LVS']"
STOCKS WITH EARNINGS UPSIDE FOR	"['SRPT', 'HAL', 'SLB', 'ALLY', 'UPST', 'NTR', 'GDDY', 'DLR', 'EXPE', 'DKS']"
GOLDMAN STOCK PICKS WITH HIGH P	"['SNPS', 'MMM', 'VMC', 'ORCL', 'CTAS', 'ALGN', 'SKX', 'SLB', 'CL', 'TPX']"
UBS¡¯ HIGH CONVICTION STOCKS WIT	"['KO', 'CRM', 'NKE', 'EOG', 'GNRC', 'AAPL', 'AAP']"
Barclays' 2022 earnings revisio	"['UAA', 'FL', 'DKS', 'SQ', 'ULTA', 'OVV', 'TDUP', 'VNOM', 'GOOGL', 'MELI']"
